activity	activity_j
12-Lipoxygenase inhibitor	12リポキシゲナーゼ阻害剤
15-Lipoxygenase inhibitor	15リポキシゲナーゼ阻害剤
3-Ketosteroid reductase inhibitor	3ケトステロイド-還元酵素阻害剤
5-alpha-reductase inhibitor	5-Alpha-還元酵素阻害剤
5-Lipoxygenase inhibitor	5リポキシゲナーゼ阻害剤
A-beta-blocker	A-beta-ブロッカー
Abortifacient	堕胎薬
Abortion	妊娠中絶
Abrasion	表皮剥脱
Abscess	膿瘍
Absorbent	吸収剤
Acaricide	ダニ駆除剤
Acetylcholinesterase inhibitor	アセチルコリンエステラーゼ阻害剤
Ache	痛み
Achylia	胃液分泌欠乏(症)、無酸素症
Acid indigestion	胃酸過多
Acidulant	酸味料
Acne	にきび、挫瘡(ざそう)
Adaptogen	適応促進薬、アダプトゲン
Adaptogenic	強壮効果
Addison's Disease	アジソン病
Adenoma	腺腫、アデノーマ
Adenosis	腺疾患、腺症
Adnexosis	-
Adrenal Insufficiency	副腎不全(症)
Adrenal stimulant	副腎刺激
Adrenergic	アドレナリン
Adrenocortical stimulant	副腎皮質刺激剤
adrenocorticotropic hormone genic 	副腎皮質刺激ホルモン生成
Adrenolytic	抗アドレナリン
Advanced glycation endproducts inhibitor	後期糖化阻害剤
Aegilops	眼内角穿孔性膿瘍
Aggregant	-
Aging	加齢
Agoraphobia	広場[臨場]恐怖(症)
Ague	悪寒
Alcohol dehydrogenase inhibitor	アルコール脱水素酵素阻害剤
Alcoholism	アルコール中毒(症)
Aldose reductase inhibitor	アルドース還元酵素阻害剤
Alexeteric	解毒作用
Algicide	殺藻剤、除藻剤
Allelochemic	アレロケミカル
Allergenic	アレルギー生成
Alopecia	脱毛(症)
Alpha-2-adrenergic agonist	Alpha-2-アドレナリン作動薬
Alpha-2-adrenergic Inhibitor	Alpha-2-アドレナリン阻害薬
Alpha-adrenergic	Alpha受容体、アルファアドレナリン受容体
Alpha-adreno inhibitor	Alpha副腎阻害剤
Alpha-amylase Inhibitor	Alphaアミラーゼ阻害剤
Alpha-glucosidase inhibitor	Alphaグルコシダーゼ阻害剤
Alpha-mannosidase inhibitor	Alphaマンノシダーゼ-阻害剤
Alpha-reductase inhibitor	Alpha還元酵素阻害剤
Alterative	体質改善剤
Altitude sickness	高山病
Alzheimer's disease	アルツハイマー病
Amebiasis	アメーバ赤痢
Amebicide	抗アメーバ薬
Amenorrhea	無月経
Amnesia	健忘(症)
AMP inhbitor	AMP阻害剤
Amphicholeretic	-
Amylolytic	アミロース分解性
Anabolic	同化促進
Analeptic	気付け薬
Analgesic	鎮痛剤
Anaphrodisiac	制淫薬
Anaphylaxis	過敏症[性]、アナフィラキシー
Anasarca	全身水腫[浮腫]
Anatiseptic	防腐剤
Androgenic	アンドロゲン
Anemia	貧血
Anesthetic	麻酔薬
Aneuria	神経力欠乏(症)
Angina	扁桃炎
Angiogenic	血管新生
Angioprotective	血管保護
Angiotensin converting enzyme inhibitor	ACE阻害薬
Angiotensin II antagonist in peroxysomal atrial fibrillation	-
Angiotensin inhibitor	アンジオテンシン阻害剤
Angiotensin receptor blocker	アンジオテンシン受容体ブロッカー
Anhidrotic	制汗剤
Anorectic	食思減退薬、食欲抑制薬
Anorexia	食欲不振
Anorexia nervosa	神経性無食欲症
Anospasmodic	抗痙攣薬、鎮けい薬
Antacid	制酸薬
Antemetic	悪心[嘔吐]抑止の
Anthelminthic	駆虫薬、虫下し
Anti-5-hydroxytryptophan	抗5-ヒドロキシトリプトファン
Anti-benign prostatic hyperplasia 	良性前立腺肥大抑制
Anti-central nervus system tremors	中枢神経系振戦抑制
Anti-Crohn's	反クローン病
Anti-epstein-Barr virus 	抗EBウイルス
Anti-GABA-nergic	抗GABA作働性
Anti-HIV	抗HIV
Anti-HIV-integrase	抗HIV-インテグラーゼ
Anti-idiopathic Thrombocytopenic Purpura	抗特発性血小板減少性紫斑病
Anti-inflammatory bowel disease	抗炎症性腸疾患
Anti-methicillin-resistant Staphylococcus aureus	抗メチシリン耐性黄色ブドウ球菌
Anti-multiple drug resistance	抗多剤耐性
Anti-nitric oxide	抗一酸化窒素
Anti-Pre Menstrual Syndrome	月経前症候群
Anti-Spina Bifida	抗二分脊椎
Anti-tumor necrosis factor	抗腫瘍壊死因子
Anti-tumor necrosis factor alpha	抗腫瘍壊死因子アルファ
Antiabortifacient	抗流産薬
Antiabsorbent	抗吸収薬
Antiacetylcholine	抗アセチルコリン
Antiacetylcholinesterase	抗アセチルコリンエステラーゼ
Antiacne	にきび
Antiaddictive	抗習慣性
Antiadenosine	-
Antiadhesive	付着防止
Antiadrenergic	抗アドレナリン
Antiadrogenic	-
Antiaflatoxin	抗アフラトキシン
Antiaggregant	抗血小板剤
Antiaging	アンチエイジング
Antialcoholic	反アルコール
Antiallergic	抗アレルギー
Antialopecic	抗脱毛
Antialzheimeran	抗アルツハイマー
Antiamnesic	抗健忘
Antiamphetamine	抗中枢神経興奮薬
Antiamylase	抗アミラーゼ
Antiamyloid	抗アミロイド
Antianaphylactic	抗アナフィラキシー
Antiandrogenic	抗アンドロゲン
Antianemic	抗貧血
Antianginal	抗狭心症
Antiangiogenic	抗血管新生
Antianoxic	抗酸素欠乏症
Antiaphrodisiac	抗性欲剤
Antiapoptotic	抗アポトーシス
Antiappetant	-
Antiarachidonate	抗アラキドン酸
Antiaromatase	抗アロマターゼ、エストロジェン抑制
Antiarrhythmic	不整脈治療剤
Antiartherogenic	アテローム産生抑制性
Antiarthritic	抗関節炎薬
Antiascites	腹水抑制性
Antiasthmatic	抗ぜんそく
Antiatherogenic	抗動脈硬化
Antiatherosclerotic	抗アテローム硬化性
Antibabesial	抗バベシア
Antibacterial	抗菌
Antibilious	抗胆汁症
Antibiotic	抗生物質
Antiblastocytic	-
Antiblennorrhagic	抗膿漏薬
Antiblister	抗水泡症
Antibradykinin	抗ブラジキニン
Antibronchitic	抗気管支炎
Antibutylcholinesterase	抗ブチルコリンエステラーゼ
Anticancer	抗ガン
Anticancer, breast	抗ガン、乳ガン
Anticancer, colon	抗ガン、結腸
Anticancer, lung	抗ガン、肺
Anticancer, mouth	抗ガン、口腔
Anticancer, oral	抗ガン、経口
Anticancer, pancreas	抗ガン、膵臓
Anticancer, prostate	抗ガン、前立腺
Anticancer, skin	抗ガン、皮膚
Anticancer, uterine	抗ガン、子宮
Anticapillary	抗毛細血管
Anticapillary Fragility	抗毛細血管脆弱性
Anticarcinogenic	抗発ガン性
Anticardiotonic	抗強心
Anticariogenic	う蝕
Anticatalase	抗カタラーゼ
Anticatarrhal	カタル治療剤
Anticatatonic	抗緊張型統合失調症
Anticatecholamine	抗カテコールアミン
Anticathartic	抗便通薬
Anticellulitis	抗蜂巣炎
Anticervisotic	-
Anticheilitic	抗口唇炎
Antichemotactic	抗化学走性
Anticholera	抗コレラ
Anticholeretic	抗利胆薬、胆汁排出抑制
Anticholestatic	胆汁鬱帯抑制
Anticholinergic	抗コリン作用薬
Anticholinesterase	抗コリンエステラーゼ
Antichronotropic	抗不整脈
Antichymotryptic	抗キモトリプシン
Anticlastogenic	抗染色体異常誘発
Anticoagulant	抗凝固剤
Anticoagulase	抗コアグラーゼ、抗血漿凝固
Anticolitic	抗大腸炎
Anticollagen	抗コラーゲン
Anticomplement	抗補体
Anticonvulsant	抗けいれん薬、抗痙攣薬
Anticonvulsive	鎮痙性
Anticoronary	抗冠状動脈性心疾患
Anticurare	抗クラーレ、クラーレ（植物）による筋肉麻痺
Anticuraroid	抗クラーレ、クラーレ（植物）による筋肉麻痺
Anticystic	抗嚢胞性
Antidandruff	ふけ予防
Antidecubitic	抗褥瘡
Antideiodinater	-
Antidementic	-
Antidemic	腫れ抑制
Antidepressant	抗鬱剤
Antidermatitic	抗皮膚炎
Antidermatophytic	抗糸状菌
Antidiabetic	抗糖尿病薬
Antidiaphoretic	抗発汗性
Antidiarrheal	止瀉薬
Antidiarrheic	下痢止め
Antidiphtheric	抗ジフテリア
Antidipsomaniac	抗アルコール依存
Antidiptheric	抗ジフテリア
Antidiuretic	抗利尿薬
Antidopamine	抗ドーパミン
Antidotal	解毒
Antidote	解毒剤
Antidote (abrin)	解毒剤、アブリン
Antidote (alcohol)	解毒剤、アルコール
Antidote (alkaloid)	解毒剤、アルカロイド
Antidote (aluminum)	解毒剤、アルミニウム
Antidote (araceae)	解毒剤、サトイモ科
Antidote (arsenic)	解毒剤、ヒ素
Antidote (atropine)	解毒剤、アトロピン
Antidote (barbituate)	解毒剤、バルビタール
Antidote (beryllium)	解毒剤、ベリリウム
Antidote (cadmium)	解毒剤、カドミウム
Antidote (Cassava)	解毒剤、キャッサバ
Antidote (cicuta)	解毒剤、シカッタ（毒芹）
Antidote (cinnabar)	解毒剤、辰砂
Antidote (crab)	解毒剤、カニ
Antidote (curare)	解毒剤、クラーレ（植物）
Antidote (daylily)	解毒剤、ワスレグサ
Antidote (fish poison)	解毒剤、魚毒
Antidote (fish)	解毒剤、魚
Antidote (fluorine)	解毒剤、フッ素
Antidote (food poisoning)	解毒剤、食中毒
Antidote (hemlock)	解毒剤、ドクニンジン
Antidote (Hg)	解毒剤、水銀
Antidote (hippomane)	解毒剤、ヒッポマネ属
Antidote (Jatropha)	解毒剤、ジャトロファ
Antidote (lead)	解毒剤、鉛
Antidote (mercury)	解毒剤、水銀
Antidote (morphine)	解毒剤、モルヒネ
Antidote (mushroom)	解毒剤、キノコ
Antidote (narcotic)	解毒剤、麻薬
Antidote (narcotics)	解毒剤、麻薬
Antidote (nettle)	解毒剤、イラクサ
Antidote (nicotine)	解毒剤、ニコチン
Antidote (nux-vomica)	解毒剤、ホミカ
Antidote (opiate)	解毒剤、麻薬
Antidote (opium)	解毒剤、アヘン
Antidote (paraquat)	解毒剤、パラコート
Antidote (physostigmine)	解毒剤、フィソスチグミン
Antidote (poison)	解毒剤、毒
Antidote (quicksilver)	解毒剤、水銀
Antidote (Rhus)	解毒剤、ラス
Antidote (scorpion)	解毒剤、サソリ
Antidote (seafood poisoning)	解毒剤、シーフード中毒
Antidote (shellfish)	解毒剤、貝
Antidote (spider)	解毒剤、クモ
Antidote (stingray)	解毒剤、エイ
Antidote (Strophanthus)	解毒剤、ストロファンツス属
Antidote (strychnine)	解毒剤、ストリキニーネ
Antidote (varnish)	解毒剤、ニス
Antidyscratic	抗リウマチ
Antidysenteric	抗赤痢
Antiecbolic	分娩抑制
Antiecchymotic	抗斑状出血
Antieczemic	抗湿疹
Antiedemic	抗浮腫性
Antielastase	抗エラスターゼ
Antiemetic	制吐剤
Antiemmenagogue	月経抑止剤
Antiencephalitic	抗脳炎
Antiendotoxin	抗内毒素
Antienuretic	夜尿症薬
Antiepileptic	抗癲癇作用
Antierythemic	抗紅斑
Antiescherichia	抗大腸菌
Antiestrogenic	抗エストロゲン性
Antiexudative	抗浸潤性
Antifatigue	抗疲労
Antifeedant	摂食阻害剤
Antifertility	避妊
Antifibosarcomic	抗線維肉腫
Antifibrillatory	抗細
Antifibrinolytic	抗線維素溶解薬
Antifibrositic	抗結合組織炎
Antifibrotic	抗線維化
Antifilaric	抗フィラリア
Antiflu	抗インフルエンザ
Antifumitory	抗フマリア(植物の一種）
Antifuruncular	抗癤
Antigalactic	乳汁分泌抑制剤
Antigastritic	抗胃炎
Antigenotoxic	抗遺伝毒性
Antigiardial	抗ランブル鞭毛虫
Antigingivitic	抗歯肉炎
Antiglaucomic	抗緑内障性
Antiglioma	抗神経膠腫
Antiglucocorticoid	抗糖質コルチコイド
Antigluconeogenic	-
Antiglucosyltransferase	抗グルコシルトランスフェラーゼ
Antiglucuronidase	抗グルクロニダーゼ
Antiglutamate	グルタミン酸抑制
Antigonadotropic	抗性腺
Antigonorrheal	抗淋病
Antigout	抗痛風
Antigranulation	抗肉芽形成
Antigranuloma	抗肉芽腫
Antihalitosic	口臭予防
Antihelicobacter	抗ヘリコバクテリア
Antihemolytic	抗溶血性
Antihemorrhagic	抗出血性
Antihemostatic	抗止血
Antihepatitic	抗肝炎
Antihepatomic	-
Antihepatosis	抗肝臓症
Antihepatotoxic	抗肝毒性
Antiherpetic	抗ヘルペス
Antihidrotic	汗止め
Antihistaminic	抗ヒスタミン薬
Antihomocysteine	ホモステイン抑制
Antihormonal	抗ホルモン
Antihyaluronidase	抗ヒアルロニダーゼ
Antihydrotic	制汗剤
Antihyperglycemic	血糖降下
Antihyperlipidemic	抗脂質異常症
Antihypertensive	降圧剤
Antihyperthyroid	甲状腺機能亢進抑制
Antihyperuricemic	抗尿酸降下
Antihypoglycemic	抗低血糖
Antihypothyroid	抗甲状腺機能低下
Antihypoxic	抗低酸素
Antihyroid	抗甲状腺
Antihysteric	抗ヒステリー
Antiileus	抗腸閉塞
Antiimmunosuppressant	抗免疫抑制
Antiimplantation	抗移植性転移
Antiinfective	抗感染症薬
Antiinfertility	不妊症治療薬
Antiinflammatory	抗炎症
Antiinsomniac	不眠抑制
Antiintegrase	抗インテグラーゼ
Antiirritant	抗刺激薬
Antiischemic	抗虚血
Antiitch	かゆみ止め
Antilactagogue	抗催乳薬
Antileishmanic	抗レーシュマニア
Antileprotic	抗ハンセン菌薬
Antileukemic	抗白血病
Antileukocyte	抗白血球
Antileukocytopenic	抗白血球減少
Antileukotriene	抗ロイコトリエン
Antilipidemic	抗脂質異常症剤
Antilipolytic	抗脂肪分解
Antilipoperoxidant	抗リポペルオキシダント
Antilithic	抗結石
Antilymphedemic	抗リンパ水腫
Antilymphocytic	抗リンパ球
Antilymphosarcomic	リンパ腫
Antimaculitic	-
Antimastitic	抗乳腺炎
Antimastocytotic	-
Antimelanic	メラニン抑制
Antimelanogenic	抗メラニン形成
Antimelanomic	抗黒皮症
Antimetabolic	代謝拮抗
Antimetaplastic	抗化生性
Antimetastatic	抗転移
Antimicrobial	抗菌剤
Antimigraine	片頭痛
Antimitogenic	抗分裂促進
Antimitotic	抗有糸分裂
Antimononucleotic	-
Antimotility	腸運動抑制
Antimutagenic	抗突然変異性
Antimyasthenic	抗筋無力性
Antimycobacterial	抗ミコバクテリア
Antimycoplasmotic	抗マイコプラズマ
Antimycotic	抗真菌薬
Antimyelotoxic	抗骨髄毒性
Antimyotoxic	抗ミオトキシン（ヘビ毒）
Antinarcotic	麻薬拮抗性
Antinauseant	制吐性
Antinecrotic	抗壊死性
Antineoplastic	抗腫瘍性
Antinephrotic	抗ネフローゼ症
Antineuralgic	抗神経痛薬
Antineuramidase	抗ニューラミダーゼ
Antineuropathic	抗神経障害性
Antineurotic	抗神経症
Antinflammatory	抗炎症
Antinicotinic	抗ニコチン
Antinitration	抗ニトロ化
Antinitrosaminic	抗ニトロソアミン
Antinitrosating	抗ニトロソ化
Antinociceptive	抗侵害受容
Antinyctalopic	抗夜盲
Antiobesity	肥満
Antiodontalgic	歯痛止め
Antiolytic	抗不安剤
Antiophidic	抗ヘビ毒
Antiosteoporotic	骨粗鬆症治療
Antiotitic	抗耳炎性
Antioxalate	オキザロ酢酸抑制
Antioxidant	酸化防止剤
Antioxytocic	抗子宮収縮
Antiozenic	抗原性
Antiparalytic	麻痺治療薬
Antiparasitic	抗寄生虫性
Antiparkinsonian	抗パーキンソン病
Antipeptic	抗ペプシン
Antiperiodic	周期病薬
Antiperiodontotic	抗歯周炎
Antiperistaltic	蠕動抑制
Antiperoxidant	抗過酸化物質
Antiperoxidase	抗ペルオキシダーゼ
Antiperspirant	制汗剤
Antiphage	抗ファージ
Antiphagocytotic	抗ファゴサイトーシス
Antiphlebitic	抗静脈炎
Antiphlegmatic	喀痰抑制
Antiphotophobic	抗光恐怖症
Antipityriasic	解熱剤
Antiplaque	歯石防止
Antiplasmodial	抗変形菌
Antiplatelet	抗血小板物質
Antipneumonic	抗肺炎
Antipolio	抗ポリオ
Antipolyp	抗ポリプ
Antiporphyric	抗ポルフィリン症
Antiprogesteronic	抗プロゲステロン
Antiprolactin	抗プロラクチン
Antiproliferative	抗増殖性
Antiprostaglandin	抗プロスタグランジン
Antiprostaglandin-E2	抗プロスタグランジン-E2
Antiprostatic	抗前立腺
Antiproteinuric	抗タンパク尿
Antiproteolytic	抗タンパク質分解
Antiprotozoal	抗原虫薬
Antipsittacotic	抗オウム病クラミジア
Antipsoriatic	抗乾癬性関節炎
Antipsychotic	抗精神病薬
Antipyretic	解熱薬
Antirabies	抗狂犬病
Antiradiation	抗放射線
Antiradicular	抗神経根
Antirejection	拒絶反応抑制
Antiretinitic	-
Antiretinohemorrhagic	-
Antiretroviral	抗レトロウイルス薬
Antirheumatalgic	-
Antirheumatic	抗リウマチ剤
Antirhinoviral	抗リノウイルス
Antiribosomal	抗リボソーム
Antisalmonella	抗サルモネラ菌
Antisarcomic	-
Antisasmodic	抗痙性
Antischistosomal	抗住血吸虫
Antisciatic	抗坐骨
Antisclerotic	抗硬化
Antiscorbuti	-
Antiscorbutic	抗壊血病
Antiscrofula	抗腺病
Antiseborrheic	抗脂漏性
Antisecretagogue	抗分泌促進物質
Antisecretory	抗分泌
Antisenility	抗老人性痴呆症
Antiseptic	防腐剤
Antiserotonin	抗セロトニン
Antiserotoninergic	抗セロトニン作動性
Antishigella	抗シゲラ菌
Antisialagogue	抗唾液分泌促進薬
Antisickling	鎌状化薬
Antispasmodic	鎮痙薬
Antispermatogenic	抗精子形成
Antistaphylococcic	抗スタフィロコッカス菌
Antisterility	抗不妊
Antisteroidogenic	抗ステロイド産生
Antistomatitic	-
Antistress	抗ストレス
Antistroke	抗卒中
Antisubtilisin	-
Antisunburn	-
Antisuppurative	抗化膿性
Antisyncytial	抗シンシチウム
Antisyphilitic	駆梅薬
Antitelomerase	抗テロメラーゼ
Antitendinitic	抗腱炎
Antitermite	抗シロアリ
Antitestosterone	抗テストステロン
Antitetanic	抗破傷風
Antithiamin	抗チアミン
Antithrombic	抗血栓症
Trichophytosis	白癬症
Antithromboxane	抗トロンボキサン
Antithyroid	抗甲状腺薬
Antitoxic	抗毒素
Antitoxoplasmotic	-
Antitubercular	抗結核
Antitumor	抗腫瘍
Antitumor proliferation	抗拡散
Antitumor promoter	抗腫瘍プロモーター
Antitumor, breast	抗腫瘍、乳房
Antitumor, CNS	抗腫瘍、中枢神経系
Antitumor, colon	抗腫瘍、結腸
Antitumor, colorectal	抗腫瘍、大腸
Antitumor, lung	抗腫瘍、肺
Antitumor, prostate	抗腫瘍、前立腺
Antitumor, skin	抗腫瘍、皮膚
Antitumor, stomach	抗腫瘍、胃
Antitussive	鎮咳薬
Antityphoid	抗チフス
Antityrosinase	抗チロシナーゼ
Antiulcerogenic	抗潰瘍
Antiultraviolet	抗紫外線
Antiultraviolet-B	抗紫外線B
Antiuremic	抗尿毒性
Antiurethrotic	-
Antiuronic acid	抗ウロン酸
Antiussive	抗鎮咳性
Antivagal	抗迷走神経
Antivaginitic	-
Antivenereal	抗性病
Antivenom	抗毒素
Antivenom (snake)	抗毒素（ヘビ）
Antiviral	抗ウイルス薬
Antiwrinkle	抗しわ
Antiyeast	抗酵母
Anuria	無尿
Anxiety	不安症
Anxiogenic	不安惹起
Anxiolytic	抗不安薬
AP-1 inhibitor	AP-1阻害剤
Aperient	緩下剤
Aperitif	食前酒
Aperitive	食欲増進薬
Aphicide	アブラムシ駆除剤
Aphrodisiac	媚薬
Aphrodisiac, female	媚薬、女性
Aphtha	アフタ
Apifuge	-
Apoplexy	卒中
Apoptotic	アポトーシス
Aposteme	-
Appendicitis	虫垂炎
Appetant	-
Aquaretic	水利尿
Aromatase inhibitor	アロマターゼ阻害剤
Aromatic	芳香
Arrhythmia	不整脈
Arrhythmogenic	催不整脈性
Artemicide	-
Arteriodilator	-
Arteriorelaxant	-
Arteriosedative	-
Arthorosis	関節症
Arthorosis (Pain)	関節症痛み
Arylamine-N-Acetyl-transferase-Inhibitor	アリール-N-アセチル-トランスフェラーゼ阻害剤
Arylsulfatase Inhibitor	アリールスルファターゼ阻害剤
Ascaricide	殺回虫剤
Ascites	腹水症
Aspergillus	アスペルギルス症
Asthenia	無力症
Asthma	喘息
Astringent	収斂性
Ataxigenic	-
Atherosclerosis	アテローム硬化症
Athlete's Foot	みずむし
Atony	アトニー
ATP-citrate lyase inhibitor	ATPのクエン酸リアーゼ阻害剤
ATPase inhibitor	ATPアーゼ-阻害剤
Atticide	-
Autoimmune Disease	自己免疫疾患
Avicide	殺鳥剤
Backache	背中の痛み
Bactericide	殺菌剤
Bacteristat	静菌剤
Balsamic	バルサム
Bat repellant	コウモリ忌避剤
Bechic	咳
Bedsore	床ずれ
Benign prostatic hyperplasia	前立腺肥大症
Beta-blocker	Beta-ブロッカー
Beta-glucosidase-inhibitor	Beta-グルコシダーゼ阻害剤
Beta-glucuronidase inhibitor	Beta-グルクロニダーゼ阻害剤
Beta-lactamase Inhibitor	Beta-ラクタマーゼ阻害剤
Bifidogenic	ビフィズス菌特異
Bilharzia	住血吸虫の寄生による感染症
Biliousness	胆汁性、短気
Bilirubinolytic	-
Bite	-
Bitter	苦味
Bladder Ailment	膀胱の病気
Bladder Stone	膀胱結石
Bleeding	出血
Blennorrhagia	淋菌性
Blennorrhea	膿漏
Blister	水疱
Bloat	鼓脹症
Bloating	膨満
Blood disorder	血液疾患
Blood thinner	血液希釈剤
Boil	おでき
Borborygmus	腹鳴
Bovinifuge	-
Bowen's Disease	ボーエン病
Bradycardiac	徐脈
Bradykinin regulator	ブラジキニンレギュレータ
Bright's disease	ブライト病
Bronchiectasis	気管支拡張症
Broncho-Vasodilator	気管血管拡張
Bronchoconstrictor	気管支収縮剤
Bronchodilator	気管支拡張剤
Broncholytic	気管支拡張
Bronchorelaxant	気管支弛緩
Bronchosecretolytic	-
Bronchosis	気管支炎
Bronchospasm	気管支けいれん、気管支痙攣
Bronchospasmogenic	-
Bronchostimulant	-
Brucellosis	ブルセラ症
Bruise	打撲傷
Bug bite	虫刺され
Bulking	バルキング
Bunion	バニオン
Bursitis	滑液包炎
Cachexia	悪液質
Cadidicide	-
Cadioactive	-
Calcium antagonist	カルシウム拮抗薬
Calcium blocker	カルシウムブロッカー
Calcium channel blocker	カルシウムチャネルブロッカー
Calculus	結石
Callus	皮膚硬結、たこ
Callus promoter	カルス-プロモーター
Calmative	鎮静効果のある
cAMP inhibitor	cAMP阻害剤
cAMP-depressant	cAMPを抑制
cAMP-genic	-
cAMP-Phosphodiesterase inhibitor	cAMP-ホスホジエステラーゼ阻害剤
Cancer	ガン
Cancer Preventive	ガン予防
Cancer, abdomen	ガン、腹部
Cancer, anus	ガン、肛門
Cancer, bladder	ガン、膀胱
Cancer, bone	ガン、骨
Cancer, breast	ガン、胸部
Cancer, brest	ガン、乳房(腺)
Cancer, cervix	ガン、子宮頚
Cancer, colon	ガン、結腸
Cancer, diaphragm	ガン、横隔膜
Cancer, duodenum	ガン、十二指腸
Cancer, ear	ガン、耳
Cancer, esophagus	ガン、食道
Cancer, eye	ガン、目
Cancer, face	ガン、顔
Cancer, foot	ガン、足
Cancer, gland	ガン、腺
Cancer, groin	ガン、鼠径部
Cancer, gum	ガン、歯肉
Cancer, head	ガン、頭
Cancer, intestine	ガン、腸
Cancer, joint	ガン、関節
Cancer, kidney	ガン、腎臓
Cancer, labial	ガン、口唇
Cancer, larynx	ガン、喉頭
Cancer, leg	ガン、下腿
Cancer, liver	ガン、肝臓
Cancer, lung	ガン、肺
Cancer, mesentery	ガン、腸間膜
Cancer, mouth	ガン、口腔
Cancer, nasopharynx	ガン、鼻咽頭
Cancer, neck	ガン、頚部
Cancer, nose	ガン、鼻
Cancer, pancreas	ガン、膵臓
Cancer, parotid	ガン、耳下
Cancer, penis	ガン、陰茎
Cancer, prostate	ガン、前立腺
Cancer, rectum	ガン、直腸
Cancer, sinew	ガン、筋肉
Cancer, sinus	ガン、洞
Cancer, skin	ガン、皮膚
Cancer, spleen	ガン、脾臓
Cancer, stomach	ガン、胃
Cancer, teat	ガン、乳首
Cancer, testes	ガン、精巣
Cancer, testicle	ガン、睾丸
Cancer, throat	ガン、咽喉
Cancer, tonsil	ガン、扁桃
Cancer, uterus	ガン、子宮
Cancer, uvula	ガン、口蓋垂
Cancer, vagina	ガン、膣
Cancer, vulva	ガン、陰門
Candidicide	-
Candidistat	-
Canicide	-
Canifuge (dog repellant)	犬忌避剤
Canker	口囲潰瘍
Canker sore	口内炎、口唇潰瘍
Capilary fragility	毛細血管脆弱症
Capillarifortificant	-
Capillariprotective	-
Capillary tonic	キャピラリートニック
Carbuncle	癰、カルブンケル
Carcinogen	発ガン物質
Carcinogenic	発ガン性
Carcinomata	ガン腫
Carcinostatic	制ガン剤
Cardiac	心臓
Cardioactive	心臓に影響を与える
Cardiodepressant	心抑制
Cardiopathy	心疾患
Cardioprotective	心臓保護
Cardiosedative	-
Cardiotonic	強心剤
Cardiotoxic	心臓毒性
Cardiovascular	心臓血管
Cardopathy	心臓障害
Caries	カリエス、骨瘍剤
Cariogenic	齲蝕原性
Carioprotective	-
Cariotonic	-
Carminative	駆風薬
Carmnative	-
Casein kinase II inhibitor	カゼインキナーゼIIの阻害剤
Caspase inducer	カスパーゼ誘導剤
Caspase stimulator	カスパーゼスティミュレータ
Caspase-3 inducer	カスパーゼ-3-低温
Catabolic	異化作用
Catacholamine inhibitor	カテコールアミン阻害剤
Catacholaminogenic	-
Cataleptic	強硬症
Cataract	白内障
Catarrh	カタル
Catechol-O-methyltransferase inhibitor	カテコール-O-メチルトランスフェラーゼ阻害剤
Catecholaminogenic	-
Cathartic	下剤
Caustic	腐食剤
Celiac	小児脂肪便症
Cell proliferant	細胞増殖
Cellulite	セリュライト
Cellulosis	-
Cercaricide	-
Cerebroprotective	脳保護
Cerebrosedative	-
Cerebrostimulant	-
Cerebrotonic	頭脳型
Cervicosis	子宮頚管炎
cGMP-phosphodiesterase inhibitor	cGMP-ホスホジエステラーゼ阻害剤
Chafing	摩擦により引き起こされた皮膚の痛みまたは炎症
Cheilosis	口角症
Chelator	キレート剤
Chemopreventive	化学防御
Chemopreventive (breast)	化学防御（乳房）
Chemopreventive (colon)	化学防御（コロン）
Chemosterilant	化学不妊剤
Chemotherapy	化学療法
Chest	胸郭
Chest ache	胸痛
Chest cold	咳かぜ
Chicken pox	水ぼうそう
Chilblains	しもやけ
Childbirth	分娩
Chill	冷え
Chitinase	キチナーゼ
Chitinolytic	キチン
Chlorosis	萎黄病(貧血)
Cholagogue	胆汁分泌促進薬
Cholecotropic	-
Cholecystokinetic	胆汁排出促進
Cholecystosis	胆嚢炎
Cholekinetic	利胆薬
Cholelithiasis	胆石症
Cholera	コレラ
Cholesteric	コレステリック
Cholicomimetic	-
Cholimimetic	-
Cholinergic	コリン作動性
Cholinolytic	抗コリン性
Cholinomimetic	コリン作用薬
Chromhidrosis	色汗症
Chronic fatigue	慢性疲労
chronic fatigue syndrome	慢性疲労症候群
Chronotropic	周期変動
Chymotrypsin inhibitor	キモトリプシン阻害剤
Cicatrizant	瘢痕形成薬
Circuladepressant	-
Circulatory stimulant	循環器刺激
Circulodepressant	-
Circulosis	-
Circulostimulant	-
Circulotonic	-
Cirrhosis	硬変
Clastogenic	染色体異常誘発
Climacteric	更年期
Cluster headache	群発(性)頭痛
CNS depressant	中枢神経系抑制剤
CNS inhibitor	中枢神経系阻害剤
CNS-active	中枢神経系活性
CNS-deobstruent	中枢神経系閉塞物の排除
CNS-depressant	中枢神経系抑制剤
CNS-paralytic	中枢神経系麻痺
CNS-sedative	中枢神経系鎮静
CNS-stimulant	中枢神経系刺激剤
Cocarcinogen	発ガン補助物質
Coccidiosis	コクシジウム病
Cold	感冒
Colic	疝痛
Colic, liver	疝痛、肝臓
Colitis	大腸炎
Collagen inhibitor	コラーゲン阻害剤
Collagen protectant	コラーゲン保護剤
Collagen protective	コラーゲン保護
Collagen sparing	コラーゲン節約作用
Collagenase inhibitor	コラゲナーゼ阻害剤
Collagenic	-
Collyrium	洗眼液
colony-stimulating factor inducer	コロニー刺激因子誘導因子
Coloprotective	-
Coma	昏睡
Comedogenic	面皰を生じやすい
Condyloma	コンジローム
Congestion	うっ血
Conjunctivosis	-
Constipation	便秘
Contraceptive	避妊薬
Convulsant	けいれんを起こす
Cooling	冷却
Copper Chelator	銅キレート剤
Cordial	興奮性飲料
Corneosis	-
Coronary	冠状動脈
Coronary vasodilator	冠拡張薬
Corroborant	強壮剤
Corticogenic	-
Corticosteroidal	コルチコステロイド
Corticosteronigenic	-
Corticotrophinogenic	-
Cortisolytic	-
Coryza	鼻感冒
Cosmetic	化粧品
Cough	咳
Counterirritant	反対刺激
Cramp	けいれん、ひきつり
Crocodile repellent	ワニ駆除剤
Crohn's Disease	クローン病
Croup	偽膜性喉頭炎
Cryptococcus	クリプトコッカス
Culebrifuge	-
Culebrifuge (snake repellant)	ヘビ忌避剤
Culicide	殺蚊剤
Curare	クラーレ
Cyanobactericide	-
Cyanogenic	青酸生産
Cyclooxygenase COX inhibitor	シクロオキシゲナーゼ阻害剤
Cyclooxygenase COX-1 inhibitor	シクロオキシゲナーゼ-1-阻害剤
Cyclooxygenase COX-2 inhibitor	シクロオキシゲナーゼ-2-阻害剤
Cyctosis	細胞増多症
Cysteine proteinase inhibitor	システイン-プロテイナーゼ阻害剤
Cystosis	-
Cytomegalovirus	サイトメガロウイルス
Cytoprotective	細胞保護
Cytostatic	細胞増殖抑制剤
Cytotoxic	細胞毒性
Dandruff	ふけ
Dart poison	-
Deafness	難聴疾患
Debility	衰弱
Decoagulant	血液凝固を防ぐかまたは遅らせる薬
Decongestant	充血除去剤
Decubosis	-
Dehydration	脱水症状
Deliriant	せん妄発生薬
Delirium	せん妄
Dementia	痴呆
Demulcent	皮膚の炎症または傷を沈静化する（油脂や軟膏等の形態の）薬物
Dengue	デング熱
Dental Plaque	歯垢、プラーク
Dentifrice	歯磨剤
Dentifuge	-
Deobstruent	閉塞物の排除
Deodorant	消臭
Depilatory	脱毛剤
Depressant	抑制薬
Depression	憂うつ症
Depurative	浄化作用
Dermabrasive	削皮
Dermagenic	-
Dermatosis	皮膚病
Desmutagenic	脱変異原
Detergent	洗浄剤
Detersive	洗浄性
Detoxicant	解毒剤
Deurative	-
Diabetes	糖尿病
Diabetic neuropathy	糖尿病性神経障害
Diaphoretic	発汗剤
Diaphragmosis	-
Diarrhea	下痢
Digestive	消化器
Dilator	拡張薬
Diphoretic	-
Diphtheria	ジフテリア
Discutient	散らし薬
Distemper	ジステンパー
Diuretic	利尿薬
Dizziness	めまい
DNA binding	DNA結合
DNA Polymerase inhibitor	DNA-ポリメラーゼ阻害剤
Dog bite	-
Dopamine antagonist	ドーパミン拮抗薬
Dopaminergic	ドーパミン作動性
Dropsy	水腫
Dry mouth	口内乾燥
Duodenitis	十二指腸炎
Duphoric	-
Dyschezia	排便障害
Dysentery	赤痢
Dysgeusia	味覚障害
Dysmenorrhea	月経困難
Dyspepsia	消化不良、胃弱
Dyspnea	呼吸困難
Dysuria	排尿障害
Earache	耳痛
Ecbolic	陣痛促進薬
Ecchymotic	斑状出血
Ectoparasite	外寄生生物
Eczema	湿疹
Edema	水しゅ、浮腫
Edemagenic	水腫形成
Elastase inhibitor	エラスターゼ阻害剤
Elephantiasis	象皮病
Emaciation	やつれ
Embolism	塞栓症
Embolizer	塞栓形成因子
Embryotoxic	胎児毒性
Emetic	催吐薬
Emmenagogue	通経薬
Emollient	緩和剤
Encephalosis	脳症
Endophinogenic	-
Energetic	精力的な
Energizer	抗鬱薬
Enterobactericide	殺腸内細菌剤
Enterodepressant	腸抑制薬
Enteroprotective	腸保護薬
Enterorelaxant	腸弛緩薬
Enterosis	-
Enterospasm	腸痙攣
Enterostimulant	腸刺激薬
Enterotonic	腸強壮剤
Enuresis	遺尿症、夜尿症、尿失禁
Epididymitis	副睾丸炎、精巣上体炎
Epigastrosis	-
Epilepsy	癲癇
Epileptogenic	てんかん発作
Epinephrinergic	-
Epistaxis	鼻出血
Epithelioma	上皮腫
Equilibratory	平衡感覚
Ergogenic	疲労回復性
Errhine	鼻汁の分泌を促進する
Eructation	おくび、げっぷ
Eruption	発疹
Erysipelas	丹毒
Escharotic	腐食剤
Esophagosis	-
Estrogen agonist	エストロゲン作用薬
Estrogenic	エストロゲン
Ethanolytic	-
Eupeptic	消化補助
Euphoriant	陶酔薬
Euphoric	陶酔
Excitant	刺激性
Exhaustion	疲労困憊
Exhilarant	興奮剤
Expectorant	去痰薬
Extrophy	外反
Farnesylation inhibitor	ファルネシル化阻害剤
Fatigue	疲労
Favus	黄癬
Fear	不安
Febrifuge	解熱剤
Felifuge (cat repellant)	猫忌避剤
Felon	ひょう疽
Female tonic	女性強壮薬
Fertility	生殖能力
Fetotoxic	胎児毒性
Fever	発熱
Fibrinolytic	線維素溶解性
Fibroid	類繊維(腫)、子宮(平滑)筋腫
Fibromyalgia	線維筋痛(症)
Fibrosarcoma	繊維肉腫
Fibrosis	繊維症
Filaria	フィラリア症
Filaricide	フィラリア駆除
Fistula	フィステル
Fits	発作
Flatugenic	-
Flu	インフルエンザ
Fluororetic	-
Fracture	骨折
Fragility	虚弱
Freckle	雀卵斑
Frigidity	冷感症、不感症
Frostbite	しもやけ、凍傷
Fullness	肥満
Fumigant	燻蒸剤
Fumitory	カラクサケマン、抗壊血病薬
Fungicide	殺菌剤、防カビ剤
Fungistat	静真菌剤
Funmitory	-
Furuncle	フルンケル
GABA antagonist	GABA拮抗薬
GABA genic	GABA生成
GABA nergic	GABA作動性
GABA reuptake inhibitor	GABA再摂取抑制剤
GABA sparing	GABA節約作用
Galactorrhea	乳汁漏出症、乳漏症、乳汁漏出
Gallstone	胆石
Gamma-interferon Inhibitor	ガンマ-インターフェロン-阻害剤
Ganglion	ガングリオン
Ganglioplegic	神経節遮断薬
Gangrene	壊疽
Gastorosis	-
Gastroenterosis	-
Gastrogogue	-
Gastroirritant	胃刺激物
Gastroprotective	胃保護剤
Gastrorelaxant	胃緩下薬
Gastrosedative	胃鎮静剤
Gastrosis	胃障害
Gastrospasm	胃痙攣
Gastrostimulant	胃刺激物
Gastrotonic	胃強壮薬
Genotoxic	遺伝毒性
Giardia	ジアルディア症
Giddiness	回転感を伴わないめまい
Gingivosis	歯肉症
Glaucoma	緑内障
Glaucomagenic	-
Gleet	後淋
Glossosis	-
Glucagonostatic	-
Gluconeogenic	糖新生
Glucose-6-phosphate dehydrogenase inhibitor	グルコース-6-リン酸脱水素酵素阻害剤
Glucosidase inhibitor	グルコシダーゼ阻害剤
Glucuronidase iInhibitor	グルクロニダーゼ阻害剤
Glucuronidase inhibitor	グルクロニダーゼ阻害剤
Glutamate dehydrogenase inhibitor	グルタミン酸脱水素酵素阻害剤
Glutaminergic	-
Glutathiogenic	-
Glutathione S-transferase inducer	グルタチオン-S-トランスフェラーゼ-低温
Glutathionigenic	-
Glycogen sparing	グリコーゲン節約作用
Glycogenic	グリコーゲン
Glycogenolytic	グリコーゲン分解
Glycolytic	糖分解
Goiter	甲状腺腫
Goitrogenic	甲状腺腫を誘発するような
Gonadotropic	性腺刺激
Gonorrhea	淋病
Gotrogenic	-
Gout	痛風
Gram(-)-incide	殺グラム陽性菌薬
Gram(+)-incide	殺グラム陽性菌薬
Granulant	-
Granulomagenic	肉芽腫生成
Gravel	尿砂
Gray hair	-
Grippe	インフルエンザ
Guanylate cyclase inhibitor	グアニル酸-シクラーゼ阻害剤
H+ATPase inhibitor	H+ATPアーゼ阻害剤
Hair dye	毛染め
Halitosis	悪臭呼気
Hallucination	幻覚
Hallucinogen	幻覚剤
Hallucinogenic	幻覚生成
Hangover	二日酔い
Hay fever	枯草熱、花粉症
HDL-Cholesterol elevation	HDLコレステロール上昇
Head cold	鼻かぜ
Headache	頭痛
Heamangiomagenic	-
Heart	心臓
Heartburn	胸やけ
Helminthicide	駆虫薬
Hemagenic	血液生成
Hemagglutinant	-
Hemagglutinator	-
Hematemesis	吐血
Hematinic	造血剤
Hematogenic	造血
Hematoma	血腫
Hematostat	止血薬
Hematuria	血尿(症)
Hemicrania	片頭痛
Hemiplegia	半身不随
Hemolytic	溶血性
Hemopareisis	-
Hemophilia	血友病
Hemoptysis	喀血
Hemorrhoids	痔核
Hemostat	止血剤
Hepatic	肝臓
Hepatocarcinogenic	肝臓ガン誘発
Hepatonic	-
Hepatoprotective	肝保護
Hepatoregenerative	肝再生
Hepatosis	肝機能不全
Hepatosis C	肝機能不全C
Hepatotonic	-
Hepatotoxic	肝毒性
Hepatotoxicity (Acetaminophen)	肝毒性
Hepatotropic	肝(臓)親和性
Hepoglycemic	-
Herbicide	除草剤
Herbistat	-
Hermorrhoid	-
Hernia	ヘルニア
Herpes	ヘルペス
Herpes zoster	帯状疱疹
Herpetofuge (snake repellant)	ヘビ忌避剤
Hiatal hernia	裂孔ヘルニア
Hiccup	しゃっくり
High blood pressure	高血圧
High blood suger	-
High cholesterol	高コレステロール
High triglyceride	高トリグリセリド
Hirudicide	殺ヒル剤
Histaminic	ヒスタミン
HIV reverse transcriptase inhibitor	HIVRT阻害剤
HIV-1 integrase inhibitor	HIV-1インテグラーゼ阻害剤
HIV-1 protease inhibitor	HIV-1プロテアーゼ阻害剤
Hives	蕁麻疹
HMG-CoA reductase inhibitor	HMG-CoAレダクターゼ-還元酵素阻害剤
Hoarseness	嗄声
Homicide	毒薬
Hookworm	鉤虫症
Hot flash	顔面潮紅、発汗性温感
Hyaluronidase inhibitor	ヒアルロニダーゼ阻害剤
Hydragogue	駆水薬
Hydrocele	水瘤、睾丸瘤
Hydrophobia	恐水病、狂犬病
Hyocholesterolemic	-
Hyoglycemic	-
Hyotensive	低血圧
Hypercalcemia	高カルシウム血症
Hypercholesterolemic	高コレステロール症
Hyperemesis	悪阻
Hyperemesis gravidarum	悪阻、つわり、妊娠悪阻
Hyperemic	充血
Hyperglycemia	高血糖症
Hyperglycemic	高血糖性
Hyperkinesis	運動過剰症
Hyperkinetic	運動過剰性
Hyperlipidemia	脂肪過剰血症
Hyperlipidemic	脂肪過剰血性
Hyperperistalsis	蠕動亢進性
Hyperphagia	摂食亢進症
Hyperphosphataemic	高リン酸血性
Hypertensive	高血圧
Hyperthermic	体温上昇
Hyperthyroid	甲状腺機能亢進性
Hypertonia	高血圧
Hypertonic	高張、高血圧性
Hypertriglyceridemic	高トリグリセリド血症
Hypnotic	睡眠薬
Hypoacidity	胃酸減少
Hypocholesterolemic	低コレステロール血
Hypochondria	憂鬱症
Hypoglycemia	低血糖症
Hypoglycemic	低血糖
Hypoinsulemic	-
Hypokalemic	低カリウム血症
Hypokinetic	運動不足
Hypolipemic	脂質低下
Trophorestorative	栄養回復剤
Hypolipidemic	低リポタンパク血、抗高脂血症薬、脂質低下薬
Hypolycemic	-
Hypoperistaltic	-
Hyporeflexic	-
Hypotensive	低血圧
Hypotention	低血圧
Hypothermic	低体温
Hypothyroid	甲状腺低下性
Hypothyroidism	甲状腺機能低下症
Hypotonic	低張、低血圧
Hypotriglyceridemic	低トリグリセリド
Hypouremic	低尿毒性
Hypouricemic	低尿酸血症
Hysteria	ヒステリー
Ichthyosis	魚鱗癬
Icterogenic	黄疸生成
IL-12 inhibitor	IL-12阻害剤
IL-1beta inhibitor	IL-1beta阻害剤
IL-2 inhibitor	IL-2阻害剤
IL-4 inhibitor	IL-4阻害剤
IL-6 inducer	IL-6誘導剤
IL-6 inhibitor	IL-6阻害剤
Ileorelaxant	-
Immnostimulant	免疫刺激剤
Immunodepressant	免疫抑制剤
Immunodepression	免疫抑制
Immunomodulator	免疫修飾因子
Immunoprotective	免疫防御
Immunostimulant	免疫賦活剤
Immunosuppressant	免疫抑制剤
Immunosuppressive	免疫抑制
Immunotonic	-
Immunotoxic	免疫毒性
Impostume	膿瘍
Impotence	インポテンツ
Incontinence	失禁
Indigestion	消化不良
Induration	硬化性
Inebriant	酔わせる物
Infanticide	毒薬
Infection	感染
Infertility	不毛
Inflammation	炎症
Inflammatory	炎症性の
Inflammatory bowel disease	炎症性腸疾患
Inorgasmia	-
iNOS genic	iNOS生成
iNOS inhibitor	iNOS阻害剤
Inotropic	変力性
Insanity	精神障害
Insecticide	殺虫剤
Insomnia	不眠症
Insulin sparing	インスリン節約作用
Insulinogenic	インスリン生成
Insulinomimetic	インスリン模倣性
Insulinotropic	インシュリン
Inteferonigenic	インターフェロン生成
Interferon-Synergist	インターフェロン-共力
Interleukin inhibitor	インターロイキン阻害剤
Interleukin-1beta inhibitor	インターロイキン-1beta阻害剤
Interleukinogenic	インターロイキン生成
Intermmittent claudication	-
Intertrigo	間擦疹
Intoxicant	中毒物質
Intoxication	中毒性
Invertase-Inhibitor	インベルターゼ阻害剤
Iron Chelator	鉄キレート剤
Iron-Chelator	鉄キレート剤
Irritable Bowel Syndrome	過敏性腸症候群
Irritant	刺激物
Ischemia	虚血
Ischiosis	-
Itch	かゆみ
Ixodicide	マダニ駆除薬
Jaundice	黄疸
Juvabional	-
K+ATPase inhibitor	K+ATPアーゼ阻害剤
Kaliuretic	カリウム利尿
Kawasaki disease	川崎病
Keratolytic	角質溶解
Keratopreventive	角質予防
Keratosis	角化症
Kernel	リンパ腺
Kidney stone	腎結石
Lacatagogue	-
Lachrymatory	催涙性
Lacrimator	催涙薬
Lacrimatory	催涙性
Lacrymator	催涙物質
Lacrymatory	催涙物質
Lactafuge	-
Lactagogue	乳汁分泌促進物質、催乳物質、催乳薬
Lactifuge	乳汁分泌抑制薬、制乳薬
Lactobacillacide	殺ラクトバチルス菌剤
Lambliasis	ランブル鞭毛虫症
Lameness	足の悪い
Larvicide	幼虫駆除剤
Larvistat	-
Laryngismus	喉頭痙攣
Laryngosis	-
Laxative	下剤
Laxative (pediatric)	下剤（小児）
Lead poisoning	鉛毒
Lectinic	-
Leishmania	リーシュマニア
Leishmaniasis	リーシュマニア症
Leishmanicide	リーシュマニア駆除薬
Lens aldose reductase inhibitor	レンズアルドースレダクターゼ阻害剤
Leprosy	癩
Lethargy	嗜眠
Leucocytogenic	-
Leucorrhea	白帯下、こしけ
Leukemia	白血病
Leukocytogenic	-
Leukocytopenogenic	-
Leukocytosis	白血球増加
Leukoderma	白斑
Leukopenic	白血球減少
Leukoplakia	白板症
Leukoplakogenic	-
Leukorrhea	白帯下、こしけ
Lichen planus	扁平苔癬
Liniment	塗薬
Lipase promoter	リパーゼ-プロモーター
Lipogenic	脂質生成
Lipolytic	脂肪分解
Lipoperoxidase inhibitor	リポパーオオキシド阻害剤
Lipotropic	脂肪親和性
Lipoxygenase inhibitor	リポキシゲナーゼ阻害剤
Lithogenic	結石生成性
Litholytic	結石溶解
Lochiostasis	悪露貯留
Locusticide	バッタ駆除剤
Longevigenic	-
Low blood pressure	低血圧
LSD chelator	LSDキレート化剤
Lumbago	腰痛症
Lungs	肺
Lupus	狼瘡
Luterinizing hormone suppressant	-
Lymph Tonic	リンパトニック
Lymphadenomic	-
Lymphadenosis	リンパ節症
Lymphagosis	-
lymphangitis	リンパ管炎
Lymphatic	リンパ管
Lymphedema	リンパ水腫
Lymphocytogenic	-
Lymphokinetic	-
Lymphoma	リンパ腫
Lymphosarcoma	リンパ肉腫
Lymphosis	-
Lymphotonic	-
Lyphocytogenic	-
Maculosis	-
Madness	狂気、狂犬病
Malaise	不定愁訴
Malaria	マラリア
Malta fever	マルタ熱
Maltase promoter	マルターゼプロモータ
Mange	疥癬
Mania	躁病
MAO inhibitor	モノアミン酸化酵素阻害剤
MAO-B inhibitor	モノアミン酸化酵素B阻害剤
Marasmus	消耗症
Mast cell stabilizer	肥満細胞スタビライザー
Masticatory	咀嚼
Mastogenic	乳生成
Mastosis	-
Matalloprotease inhibitor	金属プロテアーゼ阻害剤
Mcolytic	-
Measles	麻疹、はしか
Melancholy	ふさぎこみ
Melanoma	黒色腫、メラノーマ
Melatoninergic	メラトニン作動性
Memorigenic	-
Meningioma	髄膜腫
Meningosis	髄膜腫生成
Menopause	更年期
Menorrhagia	月経過多症
Menoxenia	月経異常
Mercury binder	水銀結合性
Metabolic Stimulant	代謝刺激
Metal-Chelator	金属キレート剤
Metalloprotease inhibitor	メタロプロテアーゼ-阻害剤
Metalloproteinase inhibitor	メタロプロテイナーゼ-阻害剤
Metastasis	転移
Meteorism	鼓脹
Metrorrhagia	子宮出血
Microcirculatory Stimulant	微小刺激
Migraine	片頭痛
Mineral corticoid	鉱質コルチコイド
Miotic	縮瞳薬
Miscarriage	流産
Miticide	ダニ殺虫剤
Mitogenic	細胞分裂
Mitotic	有糸分裂
MMP2 inhibitor	MMP2阻害剤
MMP9 inhibitor	MMP9阻害剤
Moisturizer	モイスチャライザー
Molluscicide	軟体動物駆除剤
Mononucleosis	単球増加症
Monooxygenase inducer	モノオキシゲナーゼ誘導剤
Monooxygenase inhibitor	モノオキシゲナーゼ阻害剤
Morelaxant	-
Morning sickness	早朝嘔吐
Mosquitocide	防蚊剤
Motility inhibitor	運動阻害
Motion sickness	動揺病、乗物酔い
Motor Depressant	モータ抑制
Mucilaginous	粘着性がある
Mucogenic	粘液生成
Mucoirritant	-
Mucolytic	粘液溶解薬
Mucoprotective	粘膜保護
Mucososis	-
Mucostimulant	粘膜刺激
Multidrug resistance inhibitor	多剤耐性阻害剤
Muscarinic	ムスカリン性
Musculotropic	向筋肉性
Mutagenic	変異原性
Mycobactericide	殺マイコプラズマ菌性
Mycolytic	糸状菌溶解性
Mycosis	真菌症
Mydriatic	散瞳薬
Myelosis	骨髄性白血病
Myelosuppressant	骨髄抑制薬
Myocardiocontractant	心筋コントラクタン
Myocardiodepressant	心筋抑制薬
Myocardioprotectant	心筋保護薬
Myocardioprotective	心筋保護性
Myocardiorelaxant	心筋弛緩薬
Myocardiotonic	心筋強壮薬
Myocontractant	筋肉コントラクタン
Myodepressant	筋肉抑制薬
Myofascities	-
Myoneurostimulant	筋神経腫刺激剤
Myoparalytic	-
Myorelaxant	筋肉弛緩薬
Myosis	縮瞳
Myostimulant	筋肉刺激薬
Myotic	縮瞳薬
Myotonia	筋緊張症
Myotonic	筋緊張症
Myotropic	筋親和性
Myrmecia	ミルメシア
Mytotonic	-
NADH-Oxidase inhibitor	NADH-酸化酵素阻害剤
Narcotic	麻薬
Narctotic	-
Natriuretic	ナトリウム排泄増加性
Nausea	吐き気
Nauseant	催嘔気剤
Necrolytic	壊死
Negative bathmotropic	負の心筋の興奮性
Negative chronotropic	陰性変時
Negative dromotropic	負の変伝導
Negative inotropic	陰性変力作用
Nematocide	抗線虫剤
Nephroprotective	腎保護
Nephrosis	(上皮性)腎臓症、ネフローゼ
Nephrotogenic	腎生成
Nephrotonic	腎強壮性
Nephrotoxic	腎毒性
Nervine	神経鎮静薬
Nervous anxiety	神経不安
Nervousness	神経過敏
Neuralgia	神経痛
Neurasthenia	神経衰弱症
Neuritogenic	神経突起生成
Neuroblastoma	神経芽細胞腫
Neurodepressant	神経抑制薬
Neurogenic	神経生成
Neuroleptic	神経弛緩薬
Neuromuscular blocker	神経筋遮断薬
Neuronogenic	ニューロン生成
Neuroparalysis	神経麻痺
Neuropathy	神経障害
Neuroprotective	神経保護
Neurorestorative	神経回復
Neurosedative	神経鎮静
Neurosis	神経症
Neurostimulant	神経刺激
Neurotonic	神経賦活性
Neurotoxic	神経毒
Neurotropic	向神経性
NF-AT inhibitor	NF-AT阻害剤
NF-kB inhibitor	NF-kB阻害剤
Nicotinic	ニコチン性
Nicotinism	ニコチン中毒
Night sweat	寝汗
Nitrate reductase Inhibitor	硝酸塩還元酵素阻害剤
NKC-booster	NKC効果促進剤
NKC-enhancer	NKC促進剤
NKC-genic	NKC生成
NKC-inhibitor	NKC阻害剤
NO scavenger	NOスカベンジャー
NO-genic	NO阻害剤、NO生成
Non insulin dependent diabetes mellitus	インスリン非依存性糖尿病
Nootropic	向知性
Noradrenergic	ノルアドレナリン作動性
NOS inhibitor	NOS阻害剤
Nutritive	栄養性
Nyctalopia	夜盲症
Obesity	肥満
Odontosis	歯牙発生
Oketsu syndrome	瘀血
Oligolactea	-
Oneirogenic	夢原性
Onychiosis	-
Opacity	混濁(眼疾患)
Ophthalmia	眼結膜炎、眼炎
Orchosis	-
Orexigenic	食欲刺激[促進]物質
Ornithine decarboxylase inhibitor	オルニチン脱炭酸酵素阻害剤
Osteoarthrosis	骨関節症、変形性関節症
Osteogenic	骨原性
Osteomyelosis	-
Osteoporosis	骨粗鬆症
Osteoprotectant	骨保護剤
Osteoprotective	骨保護性
Osteosarcoma	骨肉腫
Osteosis	骨組織形成
Otorrhea	耳漏
Otosis	錯聴症
Ovariosis	-
Ovary	卵巣
Ovicide	殺卵剤
Oxaluria	シュウ酸塩尿症
Oxidative phosphorylation inhibitor	酸化的リン酸化阻害剤
Oxytocic	子宮収縮剤
Oxyuricide	蟯虫駆除薬
Ozena	臭鼻症
P450 inducer	P450阻害剤
P450(2B1) inhibitor	P450(2B1)阻害剤
Pain	痛み
Palpitation	動悸
Palsy	麻痺、中風
Panacea	万能薬
Pancreaprotective	膵臓保護薬
Pancreatic	膵臓
Pancreato stimulant	膵臓刺激薬
Pancreatonic	膵臓強壮薬
Pancreatosis	-
Paradentosis	歯周症
Paralysis	中風
Paralytic	麻痺
Paramecicide	-
Paraplegia	両側麻痺
Parasiticide	虫下し、駆虫薬
Parasympathetic	副交感神経
Parasympatholytic	副交感神経遮断薬
Parasympathomimetic	副交感神経作用
Parasympaticolytic	-
Paratyphus	パラチフス
Parotosis	-
Parturient	分娩
Parturifacient	分娩促進
Parturition	分娩
Pectinesterase Inhibitor	ペクチンエステラーゼ阻害剤
Pectiniferous	-
Pectoral	胸筋
Pediculicide	シラミ駆除剤
Pediculosis	シラミ症
Pemphigus	天疱瘡
Peptic	消化
Pericardosis	-
Periodontosis	歯周症
Peripheral Stimulant	周辺刺激
Peripheral Vasodilator	末梢血管拡張
Peristaltic	蠕動性
Peroxidase Inhibitor	ペルオキシダーゼ阻害剤
Peroxynitrite Scavenger	ペルオキシナイトライトスカベンジャー
Pertussis	百日咳
Pesticide	農薬
Phagocytotic	食作用
Phagoytotic	-
Pharyngosis	-
Phayryngosis	-
Pheromone	フェロモン
Philtre	媚薬
Phinosis	-
Phosphodiesterase inhibitor	ホスホジエステラーゼ阻害剤
Phospholipase A2 inhibitor	ホスホリパーゼA2の阻害剤
Phospholipase inhibitor	ホスホリパーゼ阻害剤
Photocarcinogenic	光ガン原性
Photodermatitic	光線過敏性皮膚炎
Photoprotective	光防護
Photosensitive	感光性
Phototoxic	光毒性
Phthisis	肺結核
Phymata	瘤腫
Piles	痔
Pilogenic	-
Pinworm	蟯虫
Piscicide	殺魚剤
Pityriasis	粃糠疹
Plasmodicide	抗マラリア薬
Platelet activating factor inhibitor	PAF阻害剤
Pleurisy	胸膜炎
Pleurodynia	胸膜痛
Pleurosis	-
Pneumonia	肺炎
Pneumonic	肺
Poison	毒
Poison ivy	うるしかぶれ
Polio	ポリオ
Poliomyelitis	急性灰白髄炎、小児麻痺
Polycystic Ovary Syndrome	多嚢胞性卵巣疾患、多嚢卵巣症候群
Trypanosomiasis	トリパノソーマ症
Polygalacturinase inhibitor	ポリガラクツロナーゼ阻害剤
Polyp	ポリプ、隆起性病変
Polyuria	多尿症
Positive bathmotropic	正の神経･筋肉変閾性、心筋の興奮性
Positive chronotropic	陽性変時
Positive dromotropic	正変伝導
Positive Inotropic	陽性変力作用
Positively Inotropic	筋変カ作用陽性
Postoperative Nausea	術後悪心
Postparturient	分娩
Prebiotic	プレバイオティック
Pregnancy	妊娠
Premenstrual Syndrome	月経前症候群
Pressor	血圧増進
Priapistic	-
Proaggregant	-
Probiotigenic	-
Procoagulant	凝血原
Proctorrhagia	直腸出血
Proctosis	-
Progesterogenic	-
Progesteronic	プロゲステロン様作用
Prolactin inhibitor	プロラクチン阻害剤
Prolactinogenic	-
Prolapse	脱出症
Prooxidant	酸化促進剤
Propecic	-
Prostaglandigenic	-
Prostaglandin E2 inhibitor	プロスタグランジンE2阻害剤
Prostaglandin snthesis inhibitor	プロスタグランジン合成阻害剤
Prostaglandin synthetase-inhibitor	プロスタグランジン合成酵素阻害剤
Prostaglandingenic	プロスタグランジン生成
Prostatosis	-
Protease inhibitor	プロテアーゼ阻害剤
Protein kinase A inhibitor	プロテインキナーゼA阻害剤
Protein kinase C inhibitor	プロテインキナーゼC阻害剤
Protein kinase inhibitor	プロテインキナーゼ阻害剤
Protein tyrosine kinase inhibitor	タンパク質チロシンキナーゼ阻害剤
Proteinase inhibitor	プロテイナーゼ阻害剤
Proteinuria	蛋白尿
Proteoglycanogenic	-
Proteolytic	蛋白質分解性
Protisticide	原生生物駆除剤
Protopectinase inhibitor	プロトペクチナーゼ阻害剤
Prurigo	痒疹
Psittacosis	オウム病
Psoriasis	乾癬
Psychedelic	サイケデリック薬剤
Psychoactive	精神活性
Psychoanaleptic	精神刺激薬
Psychomimetic	幻覚
Psychosis	精神病
Psychostimulant	精神刺激薬
Psychotominetic	-
Psychotropic	向精神薬
Ptarmic	くしゃみ
Pterygium	翼状片
Puerperium	産褥
Pulicide	ノミ殺薬剤
Pulmonary	肺疾患
Pulmonosis	-
Pulmonotonic	-
Purgative	下剤
Pyelosis	-
Pyemia	膿血症
Pyorrhea	膿漏症
Pyrexia	発熱
Pyrogenic	発熱性
Quinone reductase activator	キノン還元酵素活性化
Quinone reductase inducer	キノン還元酵素誘導
Quinone reductase inhibitor	キノン還元酵素阻害剤
Rabies	狂犬病、恐水病
Rachosis	-
Radiation	放射物
Radioprotective	放射線防護
Rash	発疹
Raynaud's	レイノー病
Refrigerant	解熱剤
Rejuvenative	-
Rennet	レンネット
Repellent	忌避剤
Resipira stimulant	-
Respiradepressant	呼吸抑制剤
Respiraparalytic	呼吸麻痺
Respirasedative	呼吸鎮静剤
Respirastimulant	呼吸刺激剤
Respiratonic	呼吸強壮薬
Restenosis	再狭窄
Restorative	強壮薬
Retinoprotective	網膜保護
Retinosis	網膜症
Reverse Transcriptase Inhibitor	逆転写酵素阻害
Reverse trascriptase inhibitor	逆転写酵素阻害剤
Revulsive	誘導薬
Rheumatism	リウマチ
Rheumatosis	リウマチ性疾患
Rhinosis	-
Rib Ache	-
Ribosome inactivator	リボソーム不活性化
Rinderpest	牛疫
Ringworm	白癬
Roborant	強壮剤
Rodenticide	殺鼠剤
Roemheld Syndrome	Roemheld症候群
Rubefacient	発赤剤
S-Adenosylmethionine decarboxylase inhibitor	S-アデノシルメチオニン-デカルボキシラーゼ阻害剤
Salpingosis	-
Saluretic	塩分排
Sarcoma	肉腫
Scab	かさぶた
Scabicide	殺疥癬虫剤
Scabies	疥癬
Scar	瘢痕
Scarlatina	猩紅熱
Schirrhus	-
Schisonticide	-
Schistosoma	住血吸虫症
Schistosomacide	殺住血吸虫薬
Schizonticide	殺シゾント剤
Sciatica	坐骨神経痛
Scirrhus	硬性ガン
Sclerosis	硬化症
Scrofula	腺病
Scurvy	壊血病
Seasickness	船酔い
Seborrhea	皮脂漏
Secretagogue	分泌促進物質、分泌促進剤
Secretolytic	-
Secretomotor	分泌促進
Secretory	分泌
Sedative	鎮静剤
Selective estrogen receptor modulator	選択的エストロゲン受容体修飾因子
Selective serotonin reuptake inhibitors	選択的セロトニン再取り込み阻害薬
Senile dementia	老人性痴呆
Senility	老衰
Sepsis	敗血症、セプシス
Septicemia	敗血症
Serine protease inhibitor	セリンプロテアーゼ阻害剤
Serotonilytic	-
Serotoninergic	セロトニン作動性
Shampoo	シャンプー
Sialagogue	唾液分泌促進薬
Sialagogue potentiator	唾液分泌促進薬増強剤
Sialogogue	唾液分泌促進薬
Sickle cell anemia	鎌状赤血球貧血
Sinusosis	-
Smallpox	天然痘
Snake repellent	ヘビ駆除剤
Snakebite	ヘビ傷
Sniffle	鼻かぜ
Soap	石鹸
Soporific	催眠剤
Sore	潰瘍
Sore Throat	咽喉炎
Sore throat splenomegaly	-
Spamogenic	-
Sparmatogenic	-
Spasm	痙攣
Spasmogenic	収縮刺激性
Spermatogenic	精子形成
Spermatorrhea	精液漏
Spermicide	殺精子剤
Spinodepressant	脊髄抑制剤
Spinostimulant	脊髄刺激薬
Splenomegaly	巨脾症
Splenosis	脾症
Splenotonic	-
Sporicide	殺胞子剤
Sprain	捻挫
Sprue	スプルー
Staminagenic	-
Steatorrhea	脂肪便
Sterilant	滅菌剤
Sternutator	くしゃみ誘発剤
Sternutatory	くしゃみ誘発性
Steroid precursor	ステロイド前駆体
Steroid-precursor starter material progesterone, testosterone, and other steroids	ステロイド前駆体スターター材料プロゲステロン、テストステロン、およびその他のステロイド
Stimulant	興奮薬
Sting	虫さされ
Stomach distress	胃疲労
Stomachache	胃痛、腹痛
Stomachic	健胃薬
Stomatosis	口腔病、口腔症
Strangury	有痛排尿困難
Stress	ストレス
Stroke	卒中
Stupefacient	麻痺
Styptic	収れん剤
Succinate dehydrogenase inhibitor	コハク酸塩脱水素酵素阻害剤
Succinate oxygenase inhibitor	コハク酸塩オキシゲナーゼ阻害剤
Sucrase promoter	スクラーゼ-プロモーター
Sudorific	発汗促進
Sunburn	日焼け
Sunscreen	日焼け止め
Sunstroke	日射病
Suppurative	化膿性
Sweetener	甘味料
Swelling	膨潤
Symapathomimetic	交感神経様
Sympathicolytic	交感神経遮断
Sympathicomimetic	交感神経
Sympathomimetic	交感神経様
Symphathicolytic	-
Syncope	失神
Syndrome X	-
Synergist	協力筋
Syphilis	梅毒
Tachycardia	頻脈、心悸高進
Tachycardic	頻脈
Taeniacide	サナダムシ駆除薬、条虫駆除剤
Teething	乳歯発生
Telepathic	精神感応、テレパシー
Tendinitis	腱炎
Tenesmus	しぶりはら、しぶり
Tennis elbow	テニス肘
Tension	緊張
Teratogen	催奇形物質
Teratogenic	催奇形性
Teratologic	奇形
Termiticide	シロアリ駆除薬
Testicular atrophy	精巣萎縮
Testosterogenic	-
Testosteronigenic	-
Tetanus	破傷風
Thermogenic	発熱性
Thirst	口渇
Thrombocytosis	血小板増加症
Thrombogenic	血栓を作る
Thrombolytic	血栓溶解
Thrombopietic	血小板新生
Thrombosis	血栓症
Thromboxane synthetase inhibitor	トロンボキサン合成酵素阻害剤
Thumb sucking	親指のおしゃぶり
Thymoleptic	感情抑制薬
Thymolytic	胸腺融解性
Thymoprotective	胸腺保護薬
Thymostimulant	胸腺刺激薬
Thyroid	甲状腺製剤
Thyroregulator	甲状制御因子
Thyrosis	ベンチ腫
Thyrotropic	甲状腺刺激
Tinea	輪癬、タムシ
Tineacide	殺タムシ剤
Tinnitus	耳鳴り
TNF inhibitor	TNF阻害剤
TNF-genic	-
TNFalpha inhibitor	TNFアルファ阻害剤
Tonic	強壮剤
Tonsilosis	-
Toothache	歯痛
Topoisomerase II inhibitor	トポイソメラーゼ-II-阻害剤
Topoisomerase inhibitor	トポイソメラーゼ阻害剤
Topoisomerase-II-inducer	トポイソメラーゼ-II誘導剤
Toxic	毒性
Toxin	毒素
Toxoplasmosis	トキソプラズマ症
Tracheorelaxant	-
Tracheosis	-
Trachoma	トラコーマ
Tranquilizer	精神安定剤
Transdermal	経皮
Trauma	トラウマ
Tremorigenic	振戦発現性
Trichinosis	旋毛虫症
Trichomonacide	抗トリコモナス剤
Trichomoniasis	トリコモナス症
Trypanosomic	トリパノソーマ症
Trypanosomicide	抗トリパノソーマ薬
Trypsin inhibitor	トリプシン阻害剤
Trypsin potentiator	トリプシン増強剤
Tuberculosis	結核
Tuberculostatic	抗結核薬
Tumor	腫瘍
Tumor promotor	腫瘍プロモーター
Tumorigenic	発ガン性
Twitching	攣縮、単収縮
Tylosis	胼胝症
Typhoid	腸チフス
Typhus	発疹チフス
Tyrosinase inhibitor	チロシナーゼ阻害剤
Tyrosine kinase Inhibitor	チロシンキナーゼ阻害剤
Ulcer	潰瘍
Ulcerogenic	潰瘍誘発
Ulcus cruris	下腿潰瘍
Unguent	軟膏
Urease inhibitor	ウレアーゼ阻害剤
Urethrosis	-
Uricolytic	尿酸分解
Uricosuric	尿酸排せつ
Urinary acidulant	-
Urinary antiseptic	尿路消毒薬
Urinary tonic	-
Urinary tract infections	尿路感染症
Urogenitosis	-
Urolithiasis	尿石症
Uteroactive	子宮活性
Uterocontractant	子宮コントラクタント
Uterolytic	子宮溶解薬
Uteroparalytic	子宮麻痺
Uterorelaxant	子宮弛緩薬
Uterorrhagia	子宮発疹
Uterosedative	子宮鎮静剤
Uterosis	-
Uterostimulant	子宮刺激薬
Uterotonic	子宮収縮薬
UV-Screen	紫外線スクリーン
Uveosis	-
Uvulosis	-
Vagina protective	膣保護
Vaginosis	膣症
Vagolytic	迷走神経抑制
Varicosis	静脈瘤症
Vascoconstrictor	血管収縮薬、血管収縮神経
vascular endothelial growth factor inhibitor	血管内皮細胞増殖因子阻害剤
Vasculostimulant	血管刺激薬
Vasoconstrictor	血管収縮薬
Vasoconstrictor(peripheral)	血管収縮（末梢）
Vasodepressant	血管抑制薬
Vasodilator	血管拡張神経、血管拡張薬
Vasomotor Stimulant	血管刺激
Vasopresssor	血管抑制
Vasoprotective	血管保護薬
Vasorelaxant	血管平滑筋弛緩
Vasotonic	血管緊張性
Venereal disease	性行為感染症
Venotonic	静脈治療薬
Vermicide	駆虫剤
Verrucolytic	-
Vertigo	めまい
Vesicant	発疱薬
Vibriocide	殺ビブリオ菌剤
Viral hepatosis	ウイルス性肝機能不全
Viricide	殺ウイルス剤
Virustat	-
Vitamin K antagonist	ビタミンK-拮抗薬
Vitiligo	白斑
Vomiting	嘔吐
Vulnerary	傷薬、外傷にきく
Wart	疣贅
Water Retention	水保持
Wen	表皮嚢胞
Whitlow	ひょう疽
Wound	創傷
Wrinkle	しわ
Xanthine oxidase inhibitor	キサンチン酸化酵素阻害剤
Xerostomia	口腔乾燥症
Yaws	イチゴ腫
Yellow fever	黄熱
Zinc chelator	亜鉛キレート剤
(1939 rows)
